x x x x x x x x x x x x x x x x x x x x
x o x x x x x x x x x x x x x x x x x x
x o o o o o o o o o o x x x x x x x x x
x x x x x x x x x x o x x x x x x x x x
u x x o o o o x x x o x x x x x x x x x
e o o o x x o o o o o x x x x x x x x x
d x x x x x x x x x s o o o o o x x x x 
o x x x x x x x x x x x x x x x x x x x
o x x x x x x x x x x x x x x x x x x x
o x x x x x x x x x x x x x x x x x x x 
o o o o o o x x x x x x x x x x x x x x 
x x x x x o x x x x x x x x x x x x x x
x x x x x o x x x x x x x x x x x x x x
x x x x x o x x x x x x x x x x x x x x
x x x x x o x x x x x x x x x x x x x x
x x x x x x x x x x x x x x x x x x x x 
x x x x x x x x x x x x x x x x x x x x
x x x x x x x x x x x x x x x x x x x x 
x x x x x x x x x x x x x x x x x x x x 
x x x x x x x x x x x x x x x x x x x x 