x x x x x x x x x x x x x x x s x x x x
o o o x x x x x x x x x x x x o x x x x
o x o x x x x x x x x x x x x o x x x x
u x o x x o o o o o o x x o o o o o o x
e x o x x o x o x x o x x x x o x x o x
x x o x x o x o x x o x x x x o x x o x
x x o x x o o o x x o o o o o o x x o x
x x o x x x x o x x x x x x x x x x o x
x x o x x x x o x x x x x x x x x x o x
x x o x x o o o x o o o o o o o o o o x
x x o x x o x x x o x x x x x x x x o x
x x o x x o x x x o x x x x x x x x o x
x x o o o o o o o o x x x x x x x x o x
x x x x x x x x x o x x x o o o o o o x
x x x x x x x x x o x x x o x x x x x x
x x x x x x x x x o x x x o x x x x x x 
x x x x x x x x x o o o o o x x x x x x
x x x x x x x x x x x x x x x x x x x x 
x x x x x x x x x x x x x x x x x x x x 
x x x x x x x x x x x x x x x x x x x x 