x x x x x x x x x x x x x x x x x x x x
x o o o o o o o o o o o o o o o o o o x
x o x x x x o x x x x o x o x x x x o x
x o x x x x o x x x x o x o o o o o o x
s o o o o x o o o o o o x x x o x x x x
x o x x o x x x x o x o o x x o x x x u
x o x x o x x x x o x x o o o o o x o e
x o x x o o o o x o x x x x o x o x o d
x o x x x x x o o o o o x x o x o x o x
x o x x x x x o x o x o x x o x o x o x
x o o o o o o o x o x o x x o x o x o x
x o x x x x x x x o x o o o o x o x o x
x o o o o o o o o o x o x x x x o x o x
x o x x x x x x x x x o x o o o o x o x
x o o o o o o o o o o o x o x x o x o x
x o x x o x x x x x x x x o o o o x o x
x o x x o o o o o o o o o o x x x x o x
x o x x x x x x x x x x x x x x x x o x
x o o o o o o o o o o o o o o o o o o x
x x x x x x x x x x x x x x x x x x x x