x x x x x x x x x x x x x x x x x x x x
x x x x x x x x x x x x o o o o o o o x
x x o o o o o o o o o x o x o x x x o x
x x o x x x x x x x o x o x o x o o o o
u x o x o o o o o x o x o x o x o x x o
e x o x x x x x o x o x o x o x o x x o
d x o x o o o o o o s x o x o o o o o o 
o x o x o x x o x x x x o x x x x x x x
o x o x o o o o o o o o o o o o o o o x
o x o x x x x x x x x x x x x x x x o x 
o x o x o o x o o o o x o o o o o o o x 
o x o x x o x o x x o x o x x x x x x x
o x o o x o x o x x o x o o o o o o o o
o x x o x o x o x x o x x x x x o x x o
o o o o x o x o x x o o o o o x o x o o
o x x x x o x o x x x x x x o x x x o x 
o x x o o o x o o o o o x x o o o o o o
o x x o x x x x x x x o o o o x x x x o 
o o o o x x x x x x x x x x x x x x o o 
x x x o o o o o o o o o o o o o o o o x 