o o o x o o o x x x x x x x x e x x x x
o x o o o x o o o o o o o o x d o o o x
o x x x x x o x x x x x x o x x x x o x
o o o o o x o o o o o x x o o o o x o o
x x o x o x x x x x o o x x x x o x x o
s o o x o x o o o x x o x o x x o o o o
o x o x o x o x o x x o x o x x x x x x 
o x o x o o o x o o o o x o x x x x o x
o x o x x x x x x x x x x o x x x x o x
o x o x x x o o o o o o o o o o o o o o 
o x o x x x o x o x x o x o x x o x o x 
o x o x x x o x o x x o x o x x o x o x
o x o x x x o x o x x o x o x x o x o x
o x o x x x o x o x x o x o x x o x o x
o x o o o o o x o o o o x o x x o x o x
o x x x x x x x o x x o x x x x x x o x 
o o o x o o o x o x x o x o o o x x o o
x x o x o x o x o o o o x o x o x x x o 
x x o x o x o x x x x x x o x o x o o o 
x x o o o x o o o o o o o o x o o o x x 