x x x x x x x x x x x x x x x s x x x x
x x x o o o o o o o o o o o o o x o o o
x x x o x x x x x x x x x x x o x o x o
u x x o o o o o o o o o o o o o x o x o
e x x o x x x x x o x x x x x o x o x o
d x x o o o o o o o x o o o x o x o x o
o o x o x x x x x o x o x o o o x o x o
x o x o x o o o x o x o x x x x x o x o
o o x o o o x o x o x o o o o o o o x o
o x x x x x x o x o x x x x x x x x x o
o x o o o o o o o o o o o o o o o o o o
o x o x x x x x x x x x x x x x x x x o
o x o o o o o o o o o x x x x x o o o o
o x x x x x x x x x x x x x x x o x x x
o o o o o o o x o o o o o o o x o o o x
o x x x x x o x o x o x o x o o o x o x 
o x o o o x o x o x o x o x x x x x o o
o x o x o x o o o o o x o x o o o x x o 
o x o x o x x x x x x x o o o x o o o o 
o o o x o o o o o o o o o x x x x x x x 