o o o o o o x x x o o o x x x x x x x x
o x x x x o o x o o x o x x x x x o o o
o o o o x x o o o x x o o x x x o o x o
o x x o x x x x x x x x o o x o o x x o
s o x o x x x x o o o x x o o o x x o o
x o x o x x x x o x o x x x x o x x o x
x o x o o o o o o x o o o o x o o x o e
x o x x x x x x x x x x x o x x o x x d
x o o o x x x x o x x o x o x x o x x x
x o x o o x x x o x x o x o x o o x x x
x o x x o o x x o x x o x o x o x x x x
x o x x x o o x o x x o x o x o o x x x
x o x x x x o o o o o o x o x x o x x x
x x x x x x x x x x x o x o x x o o o o
x x x x o o o x x x o o x o x x x x x o
x x x x o x o x x o o x x o x x x x o o
x x x x o x o x o o x o o o x x x o o x
x x x x o x o o o x x o x o x x o o x x
x x x x o x x x x x o o x o x o o x x x
x x x x o o o o o o o x x o o o x x x x